**********************************************
*              *                             *
*   ****  ***  ****  ******   ******   ***   *
*           *                 *        *     *
*  *******  *************  ********  *****  **
*  *     *  *           *  *                 *
*  *  *  *  *  *  ***   *     ******  *****  *
*     *  *  *  *  *     *     *  *        *  *
*     ****  *  ****   ***  *  *  ***   *  *  *
*  *     *  *              *           *  *  *
*  ****  *  ********   *****  **********  *  *
*     *  *                    *              *
****  *  **   ******   ********  *******  *  *
*  *  *                    *     *     *  *  *
*     ***   *********  **  *  ****  *  *  *  *
*  *  *     *     *     *  *  *     *     *  *
*  *  *  ******   ***   *  *  *   *********  *
*     *  *                 *  *              *
****  *  *  ******* **     *  *  *************
*  *     *  *  *     *  *  *  *  *           *
*  *     *  *  ***   *  *     *     *******  *
*     *  *  *        *  *     *     *     *  *
*  *  *  *  *   ******  *  *  *     *  *  *  *
*  *  *     *           *  *     *  *  *     *
*  *  *     *************  *     *  ****     *
*     *  *                 *  *  *        *  *
*  ****  *  ******  ********  *  ******   *  *
*  *     *  *        *        *     *     *  *
*  ***   *  ******   *  *********   *******  *
*        *           *  *                    *
**********************************************
